{
  "all": {
    "predict": [
      "[001] 정답: b / 예측: b",
      "[002] 정답: c / 예측: e",
      "[003] 정답: e / 예측: b",
      "[004] 정답: b / 예측: e",
      "[005] 정답: e / 예측: e",
      "[006] 정답: e / 예측: a",
      "[007] 정답: c / 예측: e",
      "[008] 정답: d / 예측: e",
      "[009] 정답: d / 예측: a",
      "[010] 정답: e / 예측: e",
      "[011] 정답: d / 예측: b",
      "[012] 정답: a / 예측: d",
      "[013] 정답: c / 예측: ",
      "[014] 정답: b / 예측: d",
      "[015] 정답: d / 예측: c",
      "[016] 정답: a / 예측: b",
      "[017] 정답: b / 예측: e",
      "[018] 정답: e / 예측: e",
      "[019] 정답: a / 예측: e",
      "[020] 정답: b / 예측: b",
      "[021] 정답: d / 예측: d",
      "[022] 정답: b / 예측: b",
      "[023] 정답: b / 예측: e",
      "[024] 정답: b / 예측: a",
      "[025] 정답: c / 예측: e",
      "[026] 정답: a / 예측: a",
      "[027] 정답: a / 예측: e",
      "[028] 정답: b / 예측: e",
      "[029] 정답: a / 예측: c",
      "[030] 정답: c / 예측: b",
      "[031] 정답: b / 예측: b",
      "[032] 정답: a / 예측: ",
      "[033] 정답: a / 예측: e",
      "[034] 정답: c / 예측: d",
      "[035] 정답: e / 예측: e",
      "[036] 정답: d / 예측: e",
      "[037] 정답: b / 예측: a",
      "[038] 정답: d / 예측: e",
      "[039] 정답: d / 예측: ",
      "[040] 정답: e / 예측: e",
      "[041] 정답: c / 예측: e",
      "[042] 정답: b / 예측: a",
      "[043] 정답: d / 예측: e",
      "[044] 정답: b / 예측: e",
      "[045] 정답: c / 예측: e",
      "[046] 정답: a / 예측: e",
      "[047] 정답: d / 예측: e",
      "[048] 정답: e / 예측: e",
      "[049] 정답: a / 예측: e",
      "[050] 정답: d / 예측: ",
      "[051] 정답: a / 예측: e",
      "[052] 정답: b / 예측: b",
      "[053] 정답: e / 예측: e",
      "[054] 정답: b / 예측: b",
      "[055] 정답: d / 예측: e",
      "[056] 정답: a / 예측: a",
      "[057] 정답: e / 예측: e",
      "[058] 정답: c / 예측: ",
      "[059] 정답: b / 예측: a",
      "[060] 정답: e / 예측: b",
      "[061] 정답: a / 예측: d",
      "[062] 정답: d / 예측: a",
      "[063] 정답: b / 예측: d",
      "[064] 정답: c / 예측: e",
      "[065] 정답: c / 예측: e",
      "[066] 정답: c / 예측: a",
      "[067] 정답: c / 예측: b",
      "[068] 정답: c / 예측: b",
      "[069] 정답: c / 예측: a",
      "[070] 정답: c / 예측: a",
      "[071] 정답: c / 예측: a",
      "[072] 정답: c / 예측: e",
      "[073] 정답: a / 예측: b",
      "[074] 정답: e / 예측: ",
      "[075] 정답: b / 예측: ",
      "[076] 정답: c / 예측: a",
      "[077] 정답: d / 예측: ",
      "[078] 정답: c / 예측: e",
      "[079] 정답: b / 예측: a",
      "[080] 정답: c / 예측: b",
      "[081] 정답: c / 예측: a",
      "[082] 정답: c / 예측: e",
      "[083] 정답: b / 예측: e",
      "[084] 정답: c / 예측: ",
      "[085] 정답: d / 예측: e",
      "[086] 정답: c / 예측: b",
      "[087] 정답: b / 예측: e",
      "[088] 정답: c / 예측: b",
      "[089] 정답: a / 예측: ",
      "[090] 정답: c / 예측: e",
      "[091] 정답: b / 예측: a",
      "[092] 정답: c / 예측: e",
      "[093] 정답: d / 예측: a",
      "[094] 정답: c / 예측: b",
      "[095] 정답: b / 예측: e",
      "[096] 정답: c / 예측: e",
      "[097] 정답: d / 예측: b",
      "[098] 정답: c / 예측: a",
      "[099] 정답: d / 예측: e",
      "[100] 정답: c / 예측: a",
      "[101] 정답: c / 예측: e",
      "[102] 정답: b / 예측: e",
      "[103] 정답: e / 예측: e",
      "[104] 정답: d / 예측: d",
      "[105] 정답: a / 예측: b",
      "[106] 정답: a / 예측: e",
      "[107] 정답: c / 예측: c",
      "[108] 정답: e / 예측: e",
      "[109] 정답: d / 예측: e",
      "[110] 정답: c / 예측: b",
      "[111] 정답: b / 예측: e",
      "[112] 정답: a / 예측: e",
      "[113] 정답: e / 예측: b",
      "[114] 정답: d / 예측: c",
      "[115] 정답: b / 예측: a",
      "[116] 정답: c / 예측: e",
      "[117] 정답: a / 예측: e",
      "[118] 정답: e / 예측: a",
      "[119] 정답: d / 예측: e",
      "[120] 정답: b / 예측: b",
      "[121] 정답: d / 예측: b",
      "[122] 정답: c / 예측: d",
      "[123] 정답: d / 예측: e",
      "[124] 정답: a / 예측: e",
      "[125] 정답: b / 예측: e",
      "[126] 정답: e / 예측: b",
      "[127] 정답: c / 예측: a",
      "[128] 정답: b / 예측: e",
      "[129] 정답: a / 예측: e",
      "[130] 정답: c / 예측: a",
      "[131] 정답: b / 예측: e",
      "[132] 정답: d / 예측: e",
      "[133] 정답: e / 예측: b",
      "[134] 정답: b / 예측: e",
      "[135] 정답: c / 예측: e",
      "[136] 정답: a / 예측: ",
      "[137] 정답: c / 예측: e",
      "[138] 정답: b / 예측: e",
      "[139] 정답: e / 예측: d",
      "[140] 정답: c / 예측: b",
      "[141] 정답: a / 예측: e",
      "[142] 정답: d / 예측: e",
      "[143] 정답: c / 예측: a",
      "[144] 정답: d / 예측: a",
      "[145] 정답: b / 예측: e",
      "[146] 정답: e / 예측: e",
      "[147] 정답: a / 예측: e",
      "[148] 정답: c / 예측: a",
      "[149] 정답: c / 예측: e",
      "[150] 정답: d / 예측: e",
      "[151] 정답: a / 예측: a",
      "[152] 정답: e / 예측: e",
      "[153] 정답: b / 예측: e",
      "[154] 정답: e / 예측: a",
      "[155] 정답: e / 예측: d",
      "[156] 정답: a / 예측: d",
      "[157] 정답: d / 예측: b",
      "[158] 정답: e / 예측: e",
      "[159] 정답: a / 예측: a",
      "[160] 정답: c / 예측: a",
      "[161] 정답: c / 예측: e",
      "[162] 정답: d / 예측: b",
      "[163] 정답: b / 예측: d",
      "[164] 정답: c / 예측: a",
      "[165] 정답: a / 예측: a",
      "[166] 정답: b / 예측: a",
      "[167] 정답: b / 예측: c",
      "[168] 정답: a / 예측: d",
      "[169] 정답: d / 예측: d",
      "[170] 정답: a / 예측: e",
      "[171] 정답: e / 예측: e",
      "[172] 정답: a / 예측: a",
      "[173] 정답: c / 예측: d",
      "[174] 정답: c / 예측: b",
      "[175] 정답: b / 예측: d",
      "[176] 정답: c / 예측: d"
    ],
    "accuracy": 0.17613636363636365
  }
}