{
  "all": {
    "predict": [
      "[001] 정답: b / 예측: e",
      "[002] 정답: c / 예측: e",
      "[003] 정답: e / 예측: e",
      "[004] 정답: b / 예측: a",
      "[005] 정답: e / 예측: b",
      "[006] 정답: e / 예측: ",
      "[007] 정답: c / 예측: a",
      "[008] 정답: d / 예측: d",
      "[009] 정답: d / 예측: d",
      "[010] 정답: e / 예측: a",
      "[011] 정답: d / 예측: a",
      "[012] 정답: a / 예측: a",
      "[013] 정답: c / 예측: ",
      "[014] 정답: b / 예측: d",
      "[015] 정답: d / 예측: a",
      "[016] 정답: a / 예측: b",
      "[017] 정답: b / 예측: a",
      "[018] 정답: e / 예측: e",
      "[019] 정답: a / 예측: d",
      "[020] 정답: b / 예측: e",
      "[021] 정답: d / 예측: b",
      "[022] 정답: b / 예측: a",
      "[023] 정답: b / 예측: e",
      "[024] 정답: b / 예측: a",
      "[025] 정답: c / 예측: a",
      "[026] 정답: a / 예측: b",
      "[027] 정답: a / 예측: e",
      "[028] 정답: b / 예측: e",
      "[029] 정답: a / 예측: c",
      "[030] 정답: c / 예측: b",
      "[031] 정답: b / 예측: e",
      "[032] 정답: a / 예측: d",
      "[033] 정답: a / 예측: b",
      "[034] 정답: c / 예측: a",
      "[035] 정답: e / 예측: d",
      "[036] 정답: d / 예측: e",
      "[037] 정답: b / 예측: a",
      "[038] 정답: d / 예측: b",
      "[039] 정답: d / 예측: ",
      "[040] 정답: e / 예측: e",
      "[041] 정답: c / 예측: e",
      "[042] 정답: b / 예측: a",
      "[043] 정답: d / 예측: e",
      "[044] 정답: b / 예측: e",
      "[045] 정답: c / 예측: e",
      "[046] 정답: a / 예측: e",
      "[047] 정답: d / 예측: e",
      "[048] 정답: e / 예측: e",
      "[049] 정답: a / 예측: e",
      "[050] 정답: d / 예측: a",
      "[051] 정답: a / 예측: e",
      "[052] 정답: b / 예측: ",
      "[053] 정답: e / 예측: e",
      "[054] 정답: b / 예측: e",
      "[055] 정답: d / 예측: e",
      "[056] 정답: a / 예측: e",
      "[057] 정답: e / 예측: e",
      "[058] 정답: c / 예측: e",
      "[059] 정답: b / 예측: a",
      "[060] 정답: e / 예측: b",
      "[061] 정답: a / 예측: d",
      "[062] 정답: d / 예측: d",
      "[063] 정답: b / 예측: d",
      "[064] 정답: c / 예측: e",
      "[065] 정답: c / 예측: a",
      "[066] 정답: c / 예측: a",
      "[067] 정답: c / 예측: ",
      "[068] 정답: c / 예측: b",
      "[069] 정답: c / 예측: a",
      "[070] 정답: c / 예측: a",
      "[071] 정답: c / 예측: b",
      "[072] 정답: c / 예측: e",
      "[073] 정답: a / 예측: b",
      "[074] 정답: e / 예측: b",
      "[075] 정답: b / 예측: b",
      "[076] 정답: c / 예측: e",
      "[077] 정답: d / 예측: b",
      "[078] 정답: c / 예측: b",
      "[079] 정답: b / 예측: a",
      "[080] 정답: c / 예측: b",
      "[081] 정답: c / 예측: b",
      "[082] 정답: c / 예측: e",
      "[083] 정답: b / 예측: a",
      "[084] 정답: c / 예측: b",
      "[085] 정답: d / 예측: e",
      "[086] 정답: c / 예측: b",
      "[087] 정답: b / 예측: e",
      "[088] 정답: c / 예측: d",
      "[089] 정답: a / 예측: a",
      "[090] 정답: c / 예측: c",
      "[091] 정답: b / 예측: b",
      "[092] 정답: c / 예측: ",
      "[093] 정답: d / 예측: b",
      "[094] 정답: c / 예측: e",
      "[095] 정답: b / 예측: b",
      "[096] 정답: c / 예측: a",
      "[097] 정답: d / 예측: ",
      "[098] 정답: c / 예측: e",
      "[099] 정답: d / 예측: e",
      "[100] 정답: c / 예측: c",
      "[101] 정답: c / 예측: e",
      "[102] 정답: b / 예측: d",
      "[103] 정답: e / 예측: a",
      "[104] 정답: d / 예측: d",
      "[105] 정답: a / 예측: b",
      "[106] 정답: a / 예측: b",
      "[107] 정답: c / 예측: d",
      "[108] 정답: e / 예측: e",
      "[109] 정답: d / 예측: a",
      "[110] 정답: c / 예측: a",
      "[111] 정답: b / 예측: d",
      "[112] 정답: a / 예측: a",
      "[113] 정답: e / 예측: a",
      "[114] 정답: d / 예측: c",
      "[115] 정답: b / 예측: b",
      "[116] 정답: c / 예측: a",
      "[117] 정답: a / 예측: d",
      "[118] 정답: e / 예측: b",
      "[119] 정답: d / 예측: a",
      "[120] 정답: b / 예측: b",
      "[121] 정답: d / 예측: a",
      "[122] 정답: c / 예측: a",
      "[123] 정답: d / 예측: a",
      "[124] 정답: a / 예측: e",
      "[125] 정답: b / 예측: a",
      "[126] 정답: e / 예측: d",
      "[127] 정답: c / 예측: a",
      "[128] 정답: b / 예측: e",
      "[129] 정답: a / 예측: e",
      "[130] 정답: c / 예측: a",
      "[131] 정답: b / 예측: e",
      "[132] 정답: d / 예측: e",
      "[133] 정답: e / 예측: b",
      "[134] 정답: b / 예측: e",
      "[135] 정답: c / 예측: d",
      "[136] 정답: a / 예측: ",
      "[137] 정답: c / 예측: e",
      "[138] 정답: b / 예측: e",
      "[139] 정답: e / 예측: d",
      "[140] 정답: c / 예측: e",
      "[141] 정답: a / 예측: e",
      "[142] 정답: d / 예측: e",
      "[143] 정답: c / 예측: a",
      "[144] 정답: d / 예측: a",
      "[145] 정답: b / 예측: a",
      "[146] 정답: e / 예측: ",
      "[147] 정답: a / 예측: e",
      "[148] 정답: c / 예측: a",
      "[149] 정답: c / 예측: d",
      "[150] 정답: d / 예측: a",
      "[151] 정답: a / 예측: ",
      "[152] 정답: e / 예측: e",
      "[153] 정답: b / 예측: ",
      "[154] 정답: e / 예측: e",
      "[155] 정답: e / 예측: d",
      "[156] 정답: a / 예측: a",
      "[157] 정답: d / 예측: b",
      "[158] 정답: e / 예측: b",
      "[159] 정답: a / 예측: b",
      "[160] 정답: c / 예측: a",
      "[161] 정답: c / 예측: b",
      "[162] 정답: d / 예측: e",
      "[163] 정답: b / 예측: d",
      "[164] 정답: c / 예측: a",
      "[165] 정답: a / 예측: b",
      "[166] 정답: b / 예측: e",
      "[167] 정답: b / 예측: b",
      "[168] 정답: a / 예측: e",
      "[169] 정답: d / 예측: e",
      "[170] 정답: a / 예측: e",
      "[171] 정답: e / 예측: e",
      "[172] 정답: a / 예측: a",
      "[173] 정답: c / 예측: a",
      "[174] 정답: c / 예측: b",
      "[175] 정답: b / 예측: d",
      "[176] 정답: c / 예측: b"
    ],
    "accuracy": 0.1534090909090909
  }
}