{
  "all": {
    "predict": [
      "[001] 정답: b / 예측: c",
      "[002] 정답: c / 예측: a",
      "[003] 정답: e / 예측: b",
      "[004] 정답: b / 예측: b",
      "[005] 정답: e / 예측: d",
      "[006] 정답: e / 예측: c",
      "[007] 정답: c / 예측: c",
      "[008] 정답: d / 예측: c",
      "[009] 정답: d / 예측: e",
      "[010] 정답: e / 예측: e",
      "[011] 정답: d / 예측: d",
      "[012] 정답: a / 예측: e",
      "[013] 정답: c / 예측: c",
      "[014] 정답: b / 예측: b",
      "[015] 정답: d / 예측: b",
      "[016] 정답: a / 예측: c",
      "[017] 정답: b / 예측: b",
      "[018] 정답: e / 예측: e",
      "[019] 정답: a / 예측: ",
      "[020] 정답: b / 예측: b",
      "[021] 정답: d / 예측: d",
      "[022] 정답: b / 예측: b",
      "[023] 정답: b / 예측: b",
      "[024] 정답: b / 예측: e",
      "[025] 정답: c / 예측: c",
      "[026] 정답: a / 예측: a",
      "[027] 정답: a / 예측: e",
      "[028] 정답: b / 예측: d",
      "[029] 정답: a / 예측: e",
      "[030] 정답: c / 예측: d",
      "[031] 정답: b / 예측: b",
      "[032] 정답: a / 예측: d",
      "[033] 정답: a / 예측: d",
      "[034] 정답: c / 예측: d",
      "[035] 정답: e / 예측: d",
      "[036] 정답: d / 예측: b",
      "[037] 정답: b / 예측: c",
      "[038] 정답: d / 예측: d",
      "[039] 정답: d / 예측: d",
      "[040] 정답: e / 예측: d",
      "[041] 정답: c / 예측: d",
      "[042] 정답: b / 예측: e",
      "[043] 정답: d / 예측: c",
      "[044] 정답: b / 예측: b",
      "[045] 정답: c / 예측: e",
      "[046] 정답: a / 예측: d",
      "[047] 정답: d / 예측: e",
      "[048] 정답: e / 예측: e",
      "[049] 정답: a / 예측: b",
      "[050] 정답: d / 예측: d",
      "[051] 정답: a / 예측: d",
      "[052] 정답: b / 예측: d",
      "[053] 정답: e / 예측: c",
      "[054] 정답: b / 예측: b",
      "[055] 정답: d / 예측: a",
      "[056] 정답: a / 예측: e",
      "[057] 정답: e / 예측: d",
      "[058] 정답: c / 예측: c",
      "[059] 정답: b / 예측: d",
      "[060] 정답: e / 예측: d",
      "[061] 정답: a / 예측: e",
      "[062] 정답: d / 예측: d",
      "[063] 정답: b / 예측: e",
      "[064] 정답: c / 예측: d",
      "[065] 정답: c / 예측: d",
      "[066] 정답: c / 예측: a",
      "[067] 정답: c / 예측: b",
      "[068] 정답: c / 예측: c",
      "[069] 정답: c / 예측: d",
      "[070] 정답: c / 예측: d",
      "[071] 정답: c / 예측: d",
      "[072] 정답: c / 예측: c",
      "[073] 정답: a / 예측: c",
      "[074] 정답: e / 예측: d",
      "[075] 정답: b / 예측: c",
      "[076] 정답: c / 예측: b",
      "[077] 정답: d / 예측: d",
      "[078] 정답: c / 예측: b",
      "[079] 정답: b / 예측: b",
      "[080] 정답: c / 예측: d",
      "[081] 정답: c / 예측: e",
      "[082] 정답: c / 예측: b",
      "[083] 정답: b / 예측: d",
      "[084] 정답: c / 예측: d",
      "[085] 정답: d / 예측: d",
      "[086] 정답: c / 예측: d",
      "[087] 정답: b / 예측: d",
      "[088] 정답: c / 예측: c",
      "[089] 정답: a / 예측: d",
      "[090] 정답: c / 예측: e",
      "[091] 정답: b / 예측: c",
      "[092] 정답: c / 예측: d",
      "[093] 정답: d / 예측: d",
      "[094] 정답: c / 예측: a",
      "[095] 정답: b / 예측: d",
      "[096] 정답: c / 예측: c",
      "[097] 정답: d / 예측: d",
      "[098] 정답: c / 예측: d",
      "[099] 정답: d / 예측: b",
      "[100] 정답: c / 예측: c",
      "[101] 정답: c / 예측: E",
      "[102] 정답: b / 예측: d",
      "[103] 정답: e / 예측: b",
      "[104] 정답: d / 예측: E",
      "[105] 정답: a / 예측: a",
      "[106] 정답: a / 예측: d",
      "[107] 정답: c / 예측: e",
      "[108] 정답: e / 예측: c",
      "[109] 정답: d / 예측: d",
      "[110] 정답: c / 예측: d",
      "[111] 정답: b / 예측: e",
      "[112] 정답: a / 예측: d",
      "[113] 정답: e / 예측: d",
      "[114] 정답: d / 예측: e",
      "[115] 정답: b / 예측: d",
      "[116] 정답: c / 예측: d",
      "[117] 정답: a / 예측: d",
      "[118] 정답: e / 예측: b",
      "[119] 정답: d / 예측: c",
      "[120] 정답: b / 예측: d",
      "[121] 정답: d / 예측: d",
      "[122] 정답: c / 예측: b",
      "[123] 정답: d / 예측: c",
      "[124] 정답: a / 예측: e",
      "[125] 정답: b / 예측: d",
      "[126] 정답: e / 예측: d",
      "[127] 정답: c / 예측: d",
      "[128] 정답: b / 예측: b",
      "[129] 정답: a / 예측: d",
      "[130] 정답: c / 예측: b",
      "[131] 정답: b / 예측: b",
      "[132] 정답: d / 예측: d",
      "[133] 정답: e / 예측: b",
      "[134] 정답: b / 예측: b",
      "[135] 정답: c / 예측: b",
      "[136] 정답: a / 예측: d",
      "[137] 정답: c / 예측: d",
      "[138] 정답: b / 예측: e",
      "[139] 정답: e / 예측: c",
      "[140] 정답: c / 예측: d",
      "[141] 정답: a / 예측: c",
      "[142] 정답: d / 예측: e",
      "[143] 정답: c / 예측: c",
      "[144] 정답: d / 예측: c",
      "[145] 정답: b / 예측: b",
      "[146] 정답: e / 예측: d",
      "[147] 정답: a / 예측: d",
      "[148] 정답: c / 예측: b",
      "[149] 정답: c / 예측: c",
      "[150] 정답: d / 예측: c",
      "[151] 정답: a / 예측: b",
      "[152] 정답: e / 예측: a",
      "[153] 정답: b / 예측: b",
      "[154] 정답: e / 예측: e",
      "[155] 정답: e / 예측: e",
      "[156] 정답: a / 예측: d",
      "[157] 정답: d / 예측: d",
      "[158] 정답: e / 예측: c",
      "[159] 정답: a / 예측: d",
      "[160] 정답: c / 예측: d",
      "[161] 정답: c / 예측: c",
      "[162] 정답: d / 예측: d",
      "[163] 정답: b / 예측: c",
      "[164] 정답: c / 예측: a",
      "[165] 정답: a / 예측: d",
      "[166] 정답: b / 예측: d",
      "[167] 정답: b / 예측: d",
      "[168] 정답: a / 예측: d",
      "[169] 정답: d / 예측: d",
      "[170] 정답: a / 예측: a",
      "[171] 정답: e / 예측: e",
      "[172] 정답: a / 예측: d",
      "[173] 정답: c / 예측: e",
      "[174] 정답: c / 예측: d",
      "[175] 정답: b / 예측: c",
      "[176] 정답: c / 예측: c"
    ],
    "accuracy": 0.30113636363636365
  }
}